111111111111
1P0000C000C1
111101111111
100000C00EC1
111111111111