111111 111111
1PC0E1 1PC0E1
100001 100001
100001 100001
100001 100001
111111 100001