111111111111111
101C0000C0000C1
1E1000C00000001
100001111110001
1000000C000P001
1000C0000C000C1
100000000000001
111111111111111