111111111111
1P0000C00CE1
1011111111C1
100000000001
1CCCCC111101
111111C00001
111111111111